#####################################
#...................................#
#.#####.###..####.###.#########.###.#
#.....#.#.......#.#.#.#.......#.#...#
#.#...#.#.#####.#.#.#.#.#####.#.#...#
#.#...#.#.#...#.#...#.#.#...#.#.#...#
#.#...#.#.#...#.#.#.#.#.#...#.#.#...#
#.#####.#####.###.###.#####.#.#####.
#...................................#
#.#####.###.#########.###.#########
#.#...#.#.#.#.......#.#.#.#.........#
#.#...#.#.#.#.#####.#.#.#.#.#######.#
#.#...#...#.#.#...#.#...#.#.#.....#.#
#.#...#####.#.#...#.#.###.#.#.###.#.#
#.#.....#...#.....#.#...#...#...#...#
#.##.####.#########.###.#####.###.#
#...................................#
#####################################